Dan Gilbert: The surprising science of happiness
Laura Robinson: The secrets I find on the mysterious ocean floor
A community for those who like to be alone
Amit Sood: Every piece of art you've ever wanted to see -- up close and searchable
Forest for the trees: Suzanne Simard at TEDSummit
Samantha Nutt: The real harm of the global arms trade
Trevor Timm: How free is our freedom of the press?
Chris Jordan: Turning powerful stats into art
Sheryl Sandberg: Why we have too few women leaders
Simon Sinek: How great leaders inspire action
Ethan Nadelmann: Why we need to end the War on Drugs
Kristen Marhaver: How we're growing baby corals to rebuild reefs
Seema Bansal: How to fix a broken education system ... without any more money
Keolu Fox: Why genetic research must be more diverse
Prosanta Chakrabarty: Clues to prehistoric times, found in blind cavefish
Andrew Youn: 3 reasons why we can win the fight against poverty
Sebastian Thrun: Google's driverless car
Chris Milk: The birth of virtual reality as an art form
Zaria Forman: Drawings that show the beauty and fragility of Earth
Adam Grant: The surprising habits of original thinkers
Applications are now open: Apply to be a TED2017 Fellow
Raffaello D'Andrea: Meet the dazzling flying machines of the future
I am British: Alexander Betts at TEDSummit
How to make love last
Markus Fischer: A robot that flies like a bird
Is the world ready for T-rays?
Riccardo Sabatini: How to read the genome and build a human being
The most interesting ideas in architecture right now
Kang Lee: Can you really tell if a kid is lying?
Ed Yong: Zombie roaches and other parasite tales
Finding the fabulous lost cultures of ancient Peru
Sangeeta Bhatia: This tiny particle could roam your body to find tumors
Roselinde Torres: What it takes to be a great leader
Mariano Sigman: Your words may predict your future mental health
How we broke the Panama Papers story: Gerard Ryle at TEDSummit
Jennifer Kahn: Gene editing can now change an entire species -- forever
Itay Talgam: Lead like the great conductors
Norman Lear: An entertainment icon on living a life of meaning
Sebastian Junger: Our lonely society makes it hard to come home from war
Amazing TEDx trailers from around the world
The most popular talks of all time
Building blocks: Notes from Session 3 at TEDSummit
Joseph Ravenell: How barbershops can keep men healthy
There will be no miracles here: Casey Gerald at TED2016
Robert Ballard: The astonishing hidden world of the deep ocean
Career advice for millennials (and really, anyone) from Margaret Heffernan
TED.com
Tony Wyss-Coray: How young blood might help reverse aging. Yes, really
Stephen Wilkes: The passing of time, caught in a single photo
Margaret Wertheim: The beautiful math of coral
Wanda Diaz Merced: How a blind astronomer found a way to hear the stars
Nancy Etcoff: Happiness and its surprises
Tim Urban: Inside the mind of a master procrastinator
Peter Saul: Let's talk about dying
Andrew Pelling: This scientist makes ears out of apples
Ramesh Raskar: Imaging at a trillion frames per second
Negin Farsad: A highly scientific taxonomy of haters
Edith Widder: How we found the giant squid
Tan Le: A headset that reads your brainwaves
Reshma Saujani: Teach girls bravery, not perfection
Judson Brewer: A simple way to break a bad habit
Organizing principles: Notes from Session 5 of TEDSummit
Tom Hulme: What can we learn from shortcuts?
How to catch a ripple in spacetime
Lidia Yuknavitch: The beauty of being a misfit
Sanford Biggers: An artist's unflinching look at racial violence
Fields Wicker-Miurin: Learning from leadership's missing manual
Adam Driver: My journey from Marine to actor
Letter to the other half: Anand Giridharadas at TEDSummit
The deciders: Zeynep Tufekci at TEDSummit
Kenneth Lacovara: Hunting for dinosaurs showed me our place in the universe
Brian Skerry: The ocean's glory -- and horror
Experiences: Notes from Session 6 of TEDSummit
Ken Robinson: Do schools kill creativity?
Sajay Samuel: How college loans exploit students for profit
Barry Schwartz: The paradox of choice
Carol Dweck: The power of believing that you can improve
Tim Brown: Tales of creativity and play
Julia Galef: Why you think you're right -- even if you're wrong
In Case You Missed It: Lessons learned through the course of TED2016
Toni Mac: The laws that sex workers really want
TED.com
Wake Up: The invigorating talks in Session 12 of TED2016
Tabetha Boyajian: The most mysterious star in the universe
Michael Norton: How to buy happiness
Talks to watch when your family is driving you nuts
Brian Little: Who are you, really? The puzzle of personality
Jamila Raqib: The secret to effective nonviolent resistance
Adam Foss: A prosecutor's vision for a better justice system
Jackie Savitz: Save the oceans, feed the world!
Pathways: Notes from Session 4 of TEDSummit
The TED2016 film festival: The shorts shown during the conference
Tristan Harris: How better tech could protect us from distraction
Gill Hicks: I survived a terrorist attack. Here's what I learned
Sue Desmond-Hellmann: A smarter, more precise way to think about public health
Manu Prakash: A 50-cent microscope that folds like origami
Isaac Mizrahi: Fashion and creativity
Laura Indolfi: Good news in the fight against pancreatic cancer
Danielle Feinberg: The magic ingredient that brings Pixar movies to life
